ablative absolute	a constituent in Latin grammar; a noun and its modifier can function as a sentence modifier
ablaut	a vowel whose quality or length is changed to indicate linguistic distinctions (such as sing sang sung song)
abulia	a loss of will power
acephalous	lacking a head or a clearly defined head
ACTH	a hormone produced by the anterior pituitary gland that stimulates the adrenal cortex
adit	a nearly horizontal passage from the surface into a mine
adumbrate	describe roughly or briefly or give the main points or summary of 
agrapha	sayings of Jesus not recorded in the canonical Gospels
ailanthus	any of several deciduous Asian trees of the genus Ailanthus
aleatory	dependent on chance
alfresco	in the open air
algolagnia	sexual pleasure derived from inflicting or experiencing pain
alpestrine	growing at high altitudes
ament	a cylindrical spikelike inflorescence
androsterone	an androgenic hormone that is less active than testosterone
anemone fish	live associated with sea anemones
anneal	bring to a desired consistency, texture, or hardness by a process of gradually heating and cooling 
antiphon	a verse or song to be chanted or sung in response
antipode	direct opposite
apathetic	showing little or no emotion or animation 
apercu	a short synopsis
aphagia	loss of the ability to swallow
aphotic	lacking light; especially not reached by sunlight
apocarpous	(of ovaries of flowering plants) consisting of carpels that are free from one another as in buttercups or roses
appoggiatura	an embellishing note usually written in smaller size
aquavit	Scandinavian liquor usually flavored with caraway seeds
arc-boutant	a buttress that stands apart from the main structure and connected to it by an arch
archine	a Russian unit of length (71 cm)
arcuate	forming or resembling an arch
argon	a colorless and odorless inert gas; one of the six inert gases; comprises approximately 1% of the earth's atmosphere
armamentarium	the collection of equipment and methods used in the practice of medicine
ascites	accumulation of serous fluid in peritoneal cavity
aspheric	varying slightly from a perfectly spherical shape
astrolabe	an early form of sextant
atony	lack of normal muscular tension or tonus
auscultate	examine by auscultation
autolysis	lysis of plant or animal tissue by an internal process
azygous	occurring singly; not one of a pair
banquette	an upholstered bench
bathyscaph	navigable deep diving vessel for underwater exploration
benthos	a region including the bottom of the sea and the littoral zones
bespeak	be a signal for or a symptom of
bespoke	(of clothing) custom-made 
bialy	flat crusty-bottomed onion roll
bibulous	given to or marked by the consumption of alcohol 
bisque	a thick cream soup made from shellfish
bregma	the craniometric point at the junction of the sagittal and coronal sutures at the top of the cranium
cachexia	any general reduction in vitality and strength of body and mind resulting from a debilitating chronic disease
cachinnate	laugh loudly and in an unrestrained way 
cairngorm	a smoky yellow or brown quartz
caisson	a chest to hold ammunition
caliper	an instrument for measuring the distance between two points (often used in the plural)
caparison	stable gear consisting of a decorated covering for a horse, especially (formerly) for a warhorse
carpophagous	feeding on fruit
cartouch	a cartridge (usually with paper casing)
cartouche	a cartridge (usually with paper casing)
castellated	having or resembling repeated square indentations like those in a battlement
catachresis	strained or paradoxical use of words either in error (as `blatant' to mean `flagrant') or deliberately (as in a mixed metaphor: `blind mouths')
catarrhine	of or related to Old World monkeys that have nostrils together and opening downward
cecum	the cavity in which the large intestine begins and into which the ileum opens
chalcedony	a milky or greyish translucent to transparent quartz
chatoyant	varying in color when seen in different lights or from different angles
chthonic	dwelling beneath the surface of the earth 
clastic	capable of being taken apart
climbing iron	an iron spike attached to the shoe to prevent slipping on ice when walking or climbing
clinometer	an instrument used by surveyors in order to measure an angle of inclination or elevation
clinquant	glittering with gold or silver
cobnut	small nut-bearing tree much grown in Europe
coir	stiff coarse fiber from the outer husk of a coconut
collective bargaining	negotiation between an employer and trade union
condonation	a pardon by treating the offender as if the offense had not occurred
confluence	a place where things merge or flow together (especially rivers) 
contredanse	a type of folk dance in which couples are arranged in sets or face one another in a line
corvee	unpaid labor (as for the maintenance of roads) required by a lord of his vassals in lieu of taxes
corvine	relating to or resembling a crow
coxcomb	the fleshy red crest on the head of the domestic fowl and other gallinaceous birds
cunctation	the act of procrastinating; putting off or delaying or defering an action to a later time
curettage	surgery to remove tissue or growths from a bodily cavity (as the uterus) by scraping with a curette
deadeye	a dead shot
debouch	march out (as from a defile) into open ground
decalcomania	either a design that is fixed to some surface or a paper bearing the design which is to be transferred to the surface
decrepitate	to roast or calcine so as to cause to crackle or until crackling stops
delectation	a feeling of extreme pleasure or satisfaction
delft	a style of glazed earthenware; usually white with blue decoration
demotic	of or for the common people
demulcent	a medication (in the form of an oil or salve etc.) that soothes inflamed or injured skin
deracinate	pull up by or as if by the roots
descant	a decorative musical accompaniment (often improvised) added above a basic melody
desuetude	a state of inactivity or disuse 
diadem	an ornamental jeweled headdress signifying sovereignty 
digitate	resembling a finger
diopter	a unit of measurement of the refractive power of a lens which is equal to the reciprocal of the focal length measured in meters; used by oculists
dissimulate	hide (feelings) from other people 
divaricate	branch off
domino	a small rectangular block used in playing the game of dominoes; the face of each block has two equal areas that can bear 0 to 6 dots
durbar	the room in the palace of a native prince of India in which audiences and receptions occur
edema	swelling from excessive accumulation of watery fluid in cells, tissues, or serous cavities
elan	enthusiastic and assured vigor and liveliness 
emulous	characterized by or arising from emulation or imitation
entrepot	a port where merchandise can be imported and then exported without paying import duties
enucleate	remove the nucleus from (a cell)
eparchy	a diocese of the Eastern Orthodox Church
eruct	expel gas from the stomach
eructation	a reflex that expels gas noisily from the stomach through the mouth
esker	(geology) a long winding ridge of post glacial gravel and other sediment; deposited by meltwater from glaciers or ice sheets
espadrille	a sandal with a sole made of rope or rubber and a cloth upper part
espalier	a trellis on which ornamental shrub or fruit tree is trained to grow flat
esurient	extremely hungry 
etiolate	make weak by stunting the growth or development of
facial index	the ratio (in percent) of the maximum width to the maximum height of the face
fastigiate	having clusters of erect branches (often appearing to form a single column)
fauces	the passage between the back of the mouth and the pharynx
feculent	foul with waste matter
fictile	capable of being molded or modeled (especially of earth or clay or other soft material)
fiduciary	relating to or of the nature of a legal trust (i.e. the holding of something in trust for another) 
fisc	a state treasury or exchequer or a royal treasury; originally the public treasury of Rome or the emperor's private purse
flagitious	extremely wicked, deeply criminal 
flense	strip the blubber or skin from (a whale or seal)
flitch	salted and cured abdominal wall of a side of pork
fluvial	of or relating to or happening in a river
foamflower	stoloniferous white-flowered spring-blooming woodland plant
folium	a thin layer or stratum of (especially metamorphic) rock
forensic	used or applied in the investigation and establishment of facts or evidence in a court of law 
fornication	voluntary sexual intercourse between persons not married to each other
fossorial	(of limbs and feet) adapted for digging
fourfold	four times as great or many 
fraxinella	Eurasian perennial herb with white flowers that emit flammable vapor in hot weather
fulgurant	amazingly impressive; suggestive of the flashing of lightning
gallimaufry	a motley assortment of things 
gallinaceous	of or relating to or resembling a gallinacean
gavage	feeding that consists of the delivery of a nutrient solution (as through a nasal tube) to someone who cannot or will not eat
girasol	tall perennial with hairy stems and leaves; widely cultivated for its large irregular edible tubers
glans penis	the conical mass of erectile tissue that forms the head of the penis
Glengarry	a Scottish cap with straight sides and a crease along the top from front to back; worn by Highlanders as part of military dress
glycine	the simplest amino acid found in proteins and the principal amino acid in sugar cane
gnosis	intuitive knowledge of spiritual truths; said to have been possessed by ancient Gnostics
gnostic	possessing intellectual or esoteric knowledge of spiritual things 
Gnosticism	a religious orientation advocating gnosis as the way to release a person's spiritual element; considered heresy by Christian churches
gravid	in an advanced stage of pregnancy
haik	an outer garment consisting of a large piece of white cloth; worn by men and women in northern Africa
havelock	a cloth covering for a service cap with a flap extending over the back of the neck to protect the neck from direct rays of the sun
hematuria	the presence of blood in the urine; often a symptom of urinary tract disease
heterodox	characterized by departure from accepted beliefs or standards 
heterogeneous	consisting of elements that are not of the same kind or nature 
horripilation	reflex erection of hairs of the skin in response to cold or emotional stress or skin irritation
hyperopia	abnormal condition in which vision for distant objects is better than for near objects
hyperplasia	abnormal increase in number of cells
hypnagogic	sleep inducing 
hypocorism	a name of endearment (especially one using a diminutive suffix)
illation	the reasoning involved in drawing a conclusion or making a logical judgment on the basis of circumstantial evidence and prior conclusions rather than on the basis of direct observation
imbricate	used especially of leaves or bracts; overlapping or layered as scales or shingles
imperforate	not perforated; having no opening
inanition	exhaustion resulting from lack of food
indene	a colorless liquid hydrocarbon extracted from petroleum or coal tar and used in making synthetic resins
indurate	make hard or harder
inextirpable	incapable of extermination or extirpation
internecine	(of conflict) within a group or organization 
intussuscept	introvert or invaginate
invidious	containing or implying a slight or showing prejudice 
kala-azar	leishmaniasis of the viscera
karabiner	an oblong metal ring with a spring clip; used in mountaineering to attach a rope to a piton or to connect two ropes
kohl	a cosmetic preparation used by women in Egypt and Arabia to darken the edges of their eyelids
laciniate	having edges irregularly and finely slashed
lamia	(folklore) a corpse that rises at night to drink the blood of the living
landau	a four-wheel covered carriage with a roof divided into two parts (front and back) that can be let down separately
legatee	someone to whom a legacy is bequeathed
litotes	understatement for rhetorical effect (especially when expressing an affirmative by negating its contrary) 
logical positivism	the form of empiricism that bases all knowledge on perceptual experience (not on intuition or revelation)
lordosis	an abnormal inward (forward) curvature of the vertebral column
lucubrate	add details, as to an account or idea; clarify the meaning of and discourse in a learned way, usually in writing
lugubrious	excessively mournful 
luxate	move out of position
macaronic	of or containing a mixture of Latin words and vernacular words jumbled together
Mahabharata	(Hinduism) a sacred epic Sanskrit poem of India dealing in many episodes with the struggle between two rival families
mange	a persistent and contagious disease of the skin causing inflammation and itching and loss of hair; affects domestic animals (and sometimes people)
mantic	resembling or characteristic of a prophet or prophecy
mantua	loose gown of the 17th and 18th centuries
manumit	free from slavery or servitude 
mare clausum	(closed sea) a navigable body of water under the jurisdiction of a single nation
massif	a block of the earth's crust bounded by faults and shifted to form peaks of a mountain range
mater	an informal use of the Latin word for mother; sometimes used by British schoolboys or used facetiously
mazurka	a Polish national dance in triple time
meatus	a natural body passageway
meninx	a membrane (one of 3) that envelops the brain and spinal cord
mercer	a dealer in textiles (especially silks)
meretricious	tastelessly showy 
meristem	undifferentiated tissue from which new cells are formed, as at the tip of a stem or root
mesomorph	a person with a well-developed muscular body
metacenter	(shipbuilding) the point of intersection between two vertical lines, one line through the center of buoyancy of the hull of a ship in equilibrium and the other line through the center of buoyancy of the hull when the ship is inclined to one side; the distance of this intersection above the center of gravity is an indication of the stability of the ship
metagenesis	alternation of sexual and asexual generations
misogamy	hatred of marriage
misology	hatred of reasoning
misoneism	hatred of change or innovation
mitzvah	(Judaism) a good deed performed out of religious duty
moire	silk fabric with a wavy surface pattern
moke	British informal for donkey
molybdenum	a polyvalent metallic element that resembles chromium and tungsten in its properties; used to strengthen and harden steel
monitory	serving to warn
monody	music consisting of a single vocal part (usually with accompaniment)
monoplegia	paralysis of a single limb
morganatic	(of marriages) of a marriage between one of royal or noble birth and one of lower rank; valid but with the understanding that the rank of the inferior remains unchanged and offspring do not succeed to titles or property of the superior
motile	(of spores or microorganisms) capable of movement
nacelle	a streamlined enclosure for an aircraft engine
narghile	an oriental tobacco pipe with a long flexible tube connected to a container where the smoke is cooled by passing through water
nekton	the aggregate of actively swimming animals in a body of water ranging from microscopic organisms to whales
neve	the upper part of a glacier (beyond the limit of perpetual snow) where the snow turns to ice
nevus	a blemish on the skin that is formed before birth
nictitating membrane	a protective fold of skin in the eyes of reptiles and birds and some mammals
ocarina	egg-shaped terra cotta wind instrument with a mouthpiece and finger holes
omasum	the third compartment of the stomach of a ruminant
ombudsman	a government appointee who investigates complaints by private persons against the government
onyx	a chalcedony with alternating black and white bands; used in making cameos
opalescence	the visual property of something having a milky brightness and a play of colors from the surface
ophidian	limbless scaly elongate reptile; some are venomous
ornithosis	an atypical pneumonia caused by a rickettsia microorganism and transmitted to humans from infected birds
orology	the science of mountains
orpine	perennial northern temperate plant with toothed leaves and heads of small purplish-white flowers
orrery	planetarium consisting of an apparatus that illustrates the relative positions and motions of bodies in the solar system by rotation and revolution of balls moved by wheelwork; sometimes incorporated in a clock
orthoepy	the way a word or a language is customarily spoken
orthogonal	having a set of mutually perpendicular axes; meeting at right angles 
oscitancy	an involuntary intake of breath through a wide open mouth; usually triggered by fatigue or boredom
Osiris	Egyptian god of the underworld and judge of the dead; husband and brother of Isis; father of Horus
osmium	a hard brittle blue-grey or blue-black metallic element that is one of the platinum metals; the heaviest metal known
osteophyte	small abnormal bony outgrowth
oviform	rounded like an egg
ovine	of or pertaining to or of the nature of or characteristic of a sheep or sheep 
parotitis	inflammation of one or both parotid glands
parturient	of or relating to or giving birth
parvenu	a person who has suddenly risen to a higher economic status but has not gained social acceptance of others in that class
peccant	liable to sin
pedicel	a small stalk bearing a single flower of an inflorescence; an ultimate division of a common peduncle
pelf	informal terms for money
pellicle	thin protective membrane in some protozoa
penumbra	a fringe region of partial shadow around an umbra 
peplum	a flared ruffle attached to the waistline of a dress or jacket or blouse
perdition	(Christianity) the abode of Satan and the forces of evil; where sinners suffer eternal punishment 
perfidy	an act of deliberate betrayal 
pergola	a framework that supports climbing plants
periodontics	the branch of dentistry dealing with diseases of the gums and other structures around the teeth
peripeteia	a sudden and unexpected change of fortune or reverse of circumstances (especially in a literary work)
periphrasis	a style that involves indirect ways of expressing things
periphrastic	roundabout and unnecessarily wordy
peripteral	having columns on all sides
pertussis	a disease of the respiratory mucous membrane
petroglyph	a carving or line drawing on rock (especially one made by prehistoric people)
petrolatum	a semisolid mixture of hydrocarbons obtained from petroleum; used in medicinal ointments and for lubrication
phlox	any polemoniaceous plant of the genus Phlox; chiefly North American; cultivated for their clusters of flowers
photogravure	an intaglio print produced by gravure
phylactery	(Judaism) either of two small leather cases containing texts from the Hebrew Scriptures (known collectively as tefillin); traditionally worn (on the forehead and the left arm) by Jewish men during morning prayer
pilose	covered with hairs especially fine soft ones
pinchbeck	an alloy of copper and zinc that is used in cheap jewelry to imitate gold
pinnate	(of a leaf shape) featherlike; having leaflets on each side of a common axis
planation	the process of erosion whereby a level surface is produced
pleach	form or weave into a braid or braids
pleasance	a pleasant and secluded part of a garden; usually attached to a mansion
pleonasm	using more words than necessary
plethoric	excessively abundant
plication	the act of folding in parallel folds
plimsoll	a light gym shoe with a rubber sole and a canvas top
polder	low-lying land that has been reclaimed and is protected by dikes (especially in the Netherlands)
pons asinorum	a problem that severely tests the ability of an inexperienced person
pons Varolii	a band of nerve fibers linking the medulla oblongata and the cerebellum with the midbrain
poplar	any of numerous trees of north temperate regions having light soft wood and flowers borne in catkins
portcullis	gate consisting of an iron or wooden grating that hangs in the entry to a castle or fortified town; can be lowered to prevent passage
prebend	the stipend assigned by a cathedral to a canon
preferment	the act of preferring
premonition	an early warning about a future event 
preterition	suggesting by deliberately concise treatment that much of significance is omitted
pronate	turn the forearm or the hand so that the palm is directed downwards
puerperal fever	serious form of septicemia contracted by a woman during childbirth or abortion (usually attributable to unsanitary conditions); formerly widespread but now uncommon
quondam	belonging to some prior time
realgar	a rare soft orange mineral consisting of arsenic sulphide; an important ore of arsenic
rebarbative	serving or tending to repel
rebus	a puzzle where you decode a message consisting of pictures representing syllables and words 
recrudesce	happen
rectus	any of various straight muscles
recurvate	curved backward or inward
recusant	someone who refuses to conform to established standards of conduct
red lead	a reddish oxide of lead (Pb3O4) used as a pigment in paints and in glass and ceramics
relaxin	hormone secreted by the corpus luteum during the last days of pregnancy; relaxes the pelvic ligaments and prepares the uterus for labor
relict	an organism or species surviving as a remnant of an otherwise extinct flora or fauna in an environment much changed from that in which it originated
reseau	a net or mesh foundation for lace
rete	a network of intersecting blood vessels or intersecting nerves or intersecting lymph vessels
revetment	a facing (usually masonry) that supports an embankment
rogation	a solemn supplication ceremony prescribed by the church
ruth	a feeling of sympathy and sorrow for the misfortunes of others
salient	having a quality that thrusts itself into attention 
saliferous	containing or yielding salt
saprophagous	(of certain animals) feeding on dead or decaying animal matter
sarcastic	expressing or expressive of ridicule that wounds 
sassafras	yellowwood tree with brittle wood and aromatic leaves and bark; source of sassafras oil; widely distributed in eastern North America
sateen	a cotton fabric with a satiny finish
saturnalia	a wild gathering involving excessive drinking and promiscuity
saturnine	bitter or scornful 
scabrous	rough to the touch; covered with scales or scurf
scholium	a marginal note written by a scholiast (a commentator on ancient or classical literature)
seborrhea	a condition in which overactivity of the sebaceous glands causes the skin to become oily
sepsis	the presence of pus-forming bacteria or their toxins in the blood or tissues
serous	of or producing or containing serum
shako	tall hat; worn by some British soldiers on ceremonial occasions
shinplaster	paper money of little value issued on insufficient security
sibilate	make a sharp hissing sound, as if to show disapproval
sibyl	(ancient Rome) a woman who was regarded as an oracle or prophet
siphonophore	a floating or swimming oceanic colony of polyps often transparent or showily colored
skirl	make a shrill, wailing sound
slime mold	a naked mass of protoplasm having characteristics of both plants and animals; sometimes classified as protoctists
sociometry	the quantitative study of social relationships
socle	a plain plinth that supports a wall
sordino	a mute for a violin
soubrette	a pert or flirtatious young girl
spavin	a swelling of the hock joint of a horse; resulting in lameness
spline	a thin strip (wood or metal)
sprachgefuhl	an intuitive feeling for the natural idiom of a language
stative	( used of verbs (e.g. `be' or `own') and most participial adjectives) expressing existence or a state rather than an action
steatopygia	an extreme accumulation of fat on the buttocks
steatorrhea	the presence of greater than normal amounts of fat in the feces which are frothy and foul smelling and floating; a symptom of disorders of fat metabolism and malabsorption syndrome
stipule	a small leafy outgrowth at the base of a leaf or its stalk; usually occurring in pairs and soon shed
stochastic	being or having a random variable 
stoup	basin for holy water
strickle	a tool or rod used to level off grain or other granular material that is heaped in a measure
stridulate	make a shrill creaking noise by rubbing together special bodily structures
suborn	incite to commit a crime or an evil deed 
succussion	shaking a person to determine whether a large amount of liquid is present in a body cavity
sudorific	inducing perspiration
sumptuary	regulating or controlling expenditure or personal behavior
supernatant	of a liquid; floating on the surface above a sediment or precipitate
sylph	a slender graceful young woman
symposiarch	the person who proposes toasts and introduces speakers at a banquet
syntax	studies of the rules for forming admissible sentences 
tabes	wasting of the body during a chronic disease
talapoin	smallest guenon monkey; of swampy central and west African forests
Tantalus	(Greek mythology) a wicked king and son of Zeus; condemned in Hades to stand in water that receded when he tried to drink and beneath fruit that receded when he reached for it
tenesmus	painful spasm of the anal sphincter along with an urgent desire to defecate without the significant production of feces; associated with irritable bowel syndrome
tercel	male hawk especially male peregrine or gyrfalcon
tertium quid	some third thing similar to two opposites but distinct from both
thymus	a ductless glandular organ at the base of the neck that produces lymphocytes and aids in producing immunity; atrophies with age
timbale	individual serving of minced e.g. meat or fish in a rich creamy sauce baked in a small pastry mold or timbale shell
tontine	an annuity scheme wherein participants share certain benefits and on the death of any participant his benefits are redistributed among the remaining participants; can run for a fixed period of time or until the death of all but one participant
trabeated	not arcuate; having straight horizontal beams or lintels (rather than arches)
traduce	speak unfavorably about 
trepan	a drill for cutting circular holes around a center
trephine	a surgical instrument used to remove sections of bone from the skull
trews	tight-fitting trousers; usually of tartan
tympanites	distension of the abdomen that is caused by the accumulation of gas in the intestines or the peritoneal cavity
Tyr	(Norse mythology) god of war and strife and son of Odin; identified with Anglo-Saxon Tiu
tyro	someone new to a field or activity 
urticate	sting with or as with nettles and cause a stinging pain or sensation
uxorial	befitting or characteristic of a wife
uxoricide	the murder of a wife by her husband
uxorious	foolishly fond of or submissive to your wife 
valgus	a deformity in which there is an abnormal displacement of part of a limb away from the midline of the body
venule	a minute vein continuous with a capillary
vernier caliper	a caliper with a vernier scale for very fine measurements
versant	the side or slope of a mountain
virilism	the development of male secondary sexual characteristics in a female (or prematurely in a young boy)
viva voce	an examination conducted by spoken communication
viviparous	producing living young (not eggs) 
volant	with wings extended in a flying position
volar	relating to the palm of the hand or the sole of the foot
votary	a priest or priestess (or consecrated worshipper) in a non-Christian religion or cult
